10
-.-.-.-.-.-.-.-.-.-
-.-.P.-.-.-.-.-.P.W
-.-.-.-.-.-.-.-.W.-
-.-.G.-.-.-.-.-.-.-
-.-.-.-.-.P.-.-.-.P
W.-.P.-.-.-.-.-.-.-
-.-.-.-.-.-.W.-.-.-
-.-.-.-.-.-.-.-.-.-
-.-.-.-.-.-.-.-.-.P
-.-.-.-.-.W.-.-.-.-