10
-.W.-.P.-.H_P.-.-.-.-
-.-.-.-.-.-.-.-.-.-
-.-.-.-.-.-.-.-.-.-
-.-.-.-.-.-.-.-.-.-
-.-.-.-.-.-.-.-.-.-
-.-.-.-.-.-.-.-.P.-
-.-.-.-.-.G.-.S.-.-
-.-.-.-.-.-.-.W.-.-
-.-.-.-.-.-.-.-.-.-
-.-.-.-.-.-.-.-.-.W