10
G.-.-.-.W.-.-.-.-.G
-.-.-.-.H_P.-.-.P.G.-
-.P.-.-.G.-.-.-.H_P.-
W.H_P.-.-.-.-.-.-.-.P
-.-.-.-.-.-.G.-.W.-
-.-.H_P.P.-.W.-.-.-.-
G.-.-.-.-.H_P.-.-.P.-
-.-.P.-.W.-.-.G.-.H_P
-.-.-.H_P.-.-.-.-.P.-
A.-.G.-.-.P.-.-.-.-