10
-.-.-.-.W.P_G.-.-.-
-.P.-.-.-.-.-.H_P.-
P.-.-.G.-.-.-.P_G.-
W.-.-.-.-.P_G.-.-.-
P_G.-.-.-.-.-.W.-.-
-.H_P.P.-.-.G.-.-.-
G.-.-.-.H_P.-.-.P_G
-.P.-.-.P_G.-.G.-.-
-.-.-.-.-.H_P.-.P.-
A.-.-.W.-.-.-.-.-.-