10
G.-.-.-.W.P_S.-.-.-.G
.-.P_S.-.H_P.-.-.P.G
P.-.-.G.-.P_S.-.H_P.-
W.H_P.-.-.-.P_S.-.-.P
P_S.-.-.-.-.G.P_S.-.W
.-.H_P.P.-.-.-.-.P_S.-
G.P_S.-.-.-.H_P.-.P.-
-.-.P.-.W.P_S.-.G.-.H_P
-.-.-.H_P.-.-.P_S.-.P
A.-.G.-.-.P.-.-.-.-.-